AAAAAABAAAAA
AAAAAACAAAAA
BEEECCCDDDDB
AAAAAACAAAAA
AAAAAABAAAAA