ABAAAAAAAAAA
ACADDEACCCDA
ACCDAEADADAA
AAAAAEDDADEA
ACCDDDAAAAEA
ACAAAAADDDEA
ADDDEEACAAAA
AAAEAEACCDDA
ADEEADAAAAAA
AADAADACDDAA
ADDDADCCADEB
AAAAAAAAAAAA