AABAAAAAAAAA
AACAAAAAAAAA
AACAAAAAAAAA
AACEEDDAAAAA
AAFAAAFAAAAA
